,,,|,|,|,,|,,,,|,,,|,,|,,|,,,||,,
,,||,,|,|,,,|,,,,,|,,,|,,|,,,||,,
,,|,,||,,,|M,,|,,,|,,,,,|,,,|,,|,
,|,,|,,|,,|,,,,|,,|,,|,|,,,|,|,,,
,,,|,,,|,|,,|,,,|,,,,,|,,,,|,,,,|
|,|,,,,|,,|,,,,,,,|,,,,|,|,|,,,|,
,,|,,,|,,,,,|,,,|,,,,|,,,,|,,|,,|
,||,,,,|,|,,,,,|,,,|,,,,|,,|,,|,,
,|,|,,,,|,,,|,,,,,|,,|,,@,|,,|,|,
,|,,,,,|,||,,,,,|,,,,|,,,,,|,,,|,
,,,,||,,,,|,,|,,|,,|,|,,,,|,,,,|,
,,|,,|,,,|,,|,,,|,,,,|,,|,,,,|,,,
,||,,,,|,|,,,|,,|,,,,,,|,,,|,,|,,
,|,,,|,,,,||,,,|,,|,,,,|,,,,|,,|,
,|,,,|,|,||,,|,,,,,,|,,,,|,,,|,,,
,|,,,|,|,||,,|,,,,,,|,,,,|,,,|,,,