,,,|,|,|,,|,M,,|,,,|,,|,,|,,,||,,
,,||,,|,|,,,|,,,,,|,,,|,,|,,,||,,
,,|,,||,,,|,,,|,,,|,,,,,|,,,|,,|,
,|,,|,,|,,|,,,,|,,|,,|,|,,,|,|,,,
,,,|,,,|,|,,|,,,|,,,,,|,,,,|,,,,|
|,|,,,,|,,|,,@,,,,|,,,,|,|,|,,,|,
,,|,,,|,,,,,|,,,|,,,,|,,,,|,,|,,|
,||,,,,|,|,,,,,|,,,|,,,,|,,|,,|,,
,|,|,,,,|,,,|,,,,,|,,|,,,,|,,|,|,
,|,,,,,|,||,,,,,|,,,,|,,,,,|,,,|,
,,,,||,,,,|,,|,,|,,|,|,,,,|,,,,|,
,,|,,|,,,|,,|,,,|,,,,|,,|,,,,|,,,
,||,,,,|,|,,,|,,|,,,,,,|,,,|,,|,,
,|,,,|,,,,||,,,|,,|,,,,|,,,,|,,|,
,|,,,|,|,||,,|,,,,,,|,,,,|,,,|,,,
,|,,,|,|,||,,|,,,,,,|,,,,|,,,|,,,