M..#.#.#..#....#...#..#..#...##..
..##..#.#...#.....#...#..#...##..
..#..##...#...#...#.....#...#..#.
.#..#..#..#....#..#..#.#...#.#...
...#...#.#..#...#.....#....#....#
#.#....#..#.....#.#..@.#.#.#...#.
..#...#.....#...#....#....#..#..#
.##....#.#.....#...#....#..#..#..
.#.#....#...#.....#..#....#..#.#.
.#.....#.##.....#....#..#..#...#.
....##....#..#..#..#.#....#....#.
..#..#...#..#...#....#..#....#...
.##....#.#...#..#......#...#..#..
.#...#....##...#..#....#....#..#.
.#...#.#.##..#......#....#...#...