#..#.#.#..#....#...#..#..#...##..
..##..#.#...#.....#...#..#...##..
..#..##...#...#...#.....#...#..#.
.#..#..#..#....#..#..#.#...#.#...
...#...#.#..#...#.....#....#.M..#
#.#....#..#.....#.#....#.#.#...#.
..#...#.....#...#....#....#..#..#
.##....#.#.....#...#....#..#..#..
.#.#....#...#.....#..#....#..#.#.
.#.....#.##.....#....#..#..#...#.
....##....#..#..#..#.#....#....#.
..#..#...#..#...#....#..#....#...
.##....#.#...#..#......#...#..#..
.#...#....##...#..#....#....#..#.
.#...#.#.##..#......#.@..#...#...