...#.#.#..#....#...#..#..#...##..
..##..#.#...#.....#...#..#...##..
..#..##...#...#...#.....#...#..#.
.#..#..#..#....#..#..#.#...#.#...
...#@..#.#..#...#.....#....#....#
#.#....#..#.......#....#.#.#...#.
..#...#.....#...#....#....#..#..#
.##....#.#.....#...#....#..#..#..
.#.#....#...#.....#..#....#..#.#.
.#.....#.##.....#....#..M..#...#.
....##....#..#..#..#.#....#....#.
..#..#...#..#...#....#..#....#...
.##....#.#...#..#......#...#..#..
.#...#....##...#..#....#....#..#.
.#...#.#.##..#......#....#...#...
